tttttt*********tttttt
t*******************t
t*******************t
t*******************t
t*******************t
t*******************t
t*********r**********
t*******rrrrr********
t******rrrrrrr*******
t*******wwwww********
t*******wwdww********
t*******wwdww********
t********************
t********************
t********************
t*******************t
t*******************t
t*******************t
t*******************t
t*******************t
ttttttttttttttttttttt