ttttttttttttttttttttt
t*******************t
t*******************t
t*******************t
t*******************t
t*******************t
**********r*********t
********rrrrr*******t
*******rrrrrrr******t
********wwwww*******t
********wwpww*******t
********wwpww*******t
********************t
********************t
********************t
t*******************t
t*******************t
t*******************t
t*******************t
t*******************t
ttttttttttttttttttttt